18-7
......STTT.......O
.......TTT......CC
....T..T........CC
................CC
@......T.......CCC
.......TTT........
..................