8-5
CCCTTCC.
.O.TT..C
....T..T
..@....C
C......C
